7 5
. . . w w w .
. . w . . . w
p . w . f . w
. . w . . . w
. . . w w w .

