5 6
w w w w w
w . . . p
w . . . .
w . f . w
w . . . w
w w w w w