5 5
. . w w w
. . w f w
. . w . w
p . . . w
. . w w w
