10 15
w w w w w w w w w w
w . . w . . . . . w
w . w f . w w w . w
w . w w w w . w . w
w . . . . . . . . w
w w w w . w . w . w
. . . w w w . w . w
. . . w . . . w . w
. . . w . w w . . w
. . . w . . . . w w
. . . w w w w . . w
. . . . . . w w . w
. . p . . . w . . w
. . . . . . . . . w
. . . . . . w w w w
